een grap, mop = une blague
een kaars = une bougie
een pet = une casquette
een kanaal = une chaine
alledaagse zaken = des choses du quotidien (f)
een komiek = un(e) comique
een verbinding = une connexion
een depressie = une dépression
een gamer = un(e) gamer
een humoriste, komiek = un(e) humoriste
de volwassenheid, meerderjarigheid = la majorité
een facebookmuur = un mur Facebook
een batterij = une pile
een kwart = un quart
een kwarteeuw (25 jaar) = un quart de siècle
het alledaagse = le quotidien
het pensioen, op rust zijn = la retraite
een eeuw = un siècle
een zeurpiet, lastpak = un type casse-pieds
een view, weergave = une vue
saai = barbant(e)/rasoir(e)
begaafd voor = doué(e) pour
commercieel, met het doel handel te drijvel = commerçant(e)
vervelend = embêtant(e)
enerverend, spannend = énervant(e)
respectloos = irrespectueux, irrespectueuse
grappig = rigolo(te)
verlaten = abandonner
appreciëren = apprécier
overdrijven = exagérer
twijfelen (tussen) = hésiter (entre)
iemand blij maken = plaire à quelqu'un
iets verwachten = s'attendre à quelque chose
iemand verleiden (tot, om) = séduire quelqu'un (à)
(iemand) volgen = suivre (quelqu'un)
een onderwerp behandelen =  traiter un sujet
iemand boos maken = casser les pieds à quelqu'un
iemand stress geven = faire stresser quelqu'un
er ontbreekt iets = il manque quelque chose
iemand (+bv) maken = rendre quelqu'un (+adjectif)
iets/iemand voelen aankomen = sentir venir quelque chose/quelqu'un
daarentegen = en revanche